                                                                                                    
                                                                                                    
                                                                                                    
                                                                                                    
                                                                                                    
                                                                                                    
                                                                                                    
                                                                                                    
                                                                                                    
                                                                                                    
                                                                                                    
                                                                                                    
                                             O                                                      
                                               O O O                                                
                                            O O OO OOOO                                             
                                            O OO      OO                                            
                                           O O          O                                           
                                          OOO     OO O OO O                                         
                                         O  O  OO        O  O                                       
                                             OOO        OO   O                                      
                                         O  OOOOO   OOO  O   O                                      
                                         O OOOOOOOOOO  O O   O                                      
                                        O O O O  OO O   OOO                                         
                                               OOO   OOOOO   O                                      
                                        O     OOOO       O                                          
                                              O O        O   O                                      
                                        O     O  O       O  OO                                      
                                        O O   O         O    O                                      
                                              O         O                                           
                                        O     O      O OO    OO                                     
                                        O     OOOOOO          O                                     
                                            O                 O                                     
                                         O         O                                                
                                        OOOOOO  O   O OO OOOOOOO                                    
                                       OOO  O OO  O O OOO    OOOO                                   
                                     OO     O        O         OOOOO                                
                                     OO             O O OO      O  O                                
                                     O            O  O    O     OO                                  
                                     OO         O          O         O                              
                                     O       OOO           O    O  OO                               
                                     O O    O  O      O    O   OO                                   
                                     O     O   O              OOO    O  O                           
                                      O   O     O      O    OO                                      
                                       O OOO   O           O O    O     O OO                        
                                      O  O O   O            O O     O    OO                         
                                       O O O     O  O  O O    O       O    O                        
                                      O  OOO  OOOOO   O     O OOO      O    O                       
                                              O      O        O  O      O  OO                       
                                       O OOOO O             O   O O      OO                         
                                       O  O O O             O     O                                 
                                       O  OO  OO           O O OOO                                  
                                       O  OO  O   O        O    OO                                  
                                       O  OO  O     OOO   O  O  O                                   
                                          O O O      OOOO       O                                   
                                          O O O      OOO         O                                  
                                          O   O      OOO         O                                  
                                          OO OO      O O       O                                    
                                          O  OO      O  O                                           
                                              O     OO  O      OO                                   
                                             OO     OO  OO      O                                   
                                          O  OO     OOOOOO      O                                   
                                            OO      OO  OO                                          
                                            OO      OO OO O      O                                  
                                             O      OOOO  O      O                                  
                                             O      O      O                                        
                                             O      O      O      O                                 
                                             O      O      O      O                                 
                                             O      O       O      O                                
                                             O      O       O      O                                
                                                    O       O       O                               
                                             O      O               O                               
                                             O      O        O       O                              
                                             O      O        O       O                              
                                             O      O                                               
                                             O     O          O       O                             
                                             O     O          O        O                            
                                             O                         O                            
                                             O     O          O                                     
                                             O     O           O        O                           
                                                   O           O       OO                           
                                                   O                                                
                                                   O                                                
                                                   O                                                
                                                                                                    
                                                                                                    
                                                                                                    
                                                                                                    
                                                                                                    
                                                                                                    
                                                                                                    
                                                                                                    
                                                                                            O       
                                                                                                    
                                                                                                    
                                                                                                    
                                                                                                    
                                                                                                    
                                                                                                    
                                                                                                    
                                                                                                    


